############
#          S
#######   ##
#         ##
# ##########
#         ##
# # # # ####
### ### ####
#   ###    Z
############
