#############
#          S#
#######   ###
#         ###
# ###########
#         ###
# # # # #####
### ### #####
#   ###    Z#
#############
