#############
#          S#
#######    ##
#         ###
# ###########
#         ###
# # # # #####
### ### #####
#   ###    Z#
#############
